#This file was generated automatically, any extra lines will be overwritten
#Created by editor v0.0.1

NAME: Tutorial 
LAYER0_MAPTILESET: tileset01.bmp
LAYER0_SIZE: 40 40
LAYER1_MAPTILESET: tileset02.bmp
LAYER1_SIZE: 40 40
START: 5 7
EXIT: 5 36
NEXT: ./data/maps/map02.map
MAP:
LAYER0
53 53 53 53 53 53 53 35 53 53 53 53 53 53 53 53 35 53 53 53 53 53 53 53 53 53 53 53 53 53 53 53 53 53 53 53 53 53 53 53 
53 53 69 69 69 69 69 69 69 69 69 69 69 69 69 69 53 53 69 69 69 69 69 69 69 69 69 69 69 69 69 69 53 53 53 53 53 53 53 53 
53 54 0 0 0 0 0 0 0 0 0 0 0 0 0 0 52 54 0 0 0 0 0 0 0 0 0 0 0 0 0 0 52 53 53 53 53 53 53 53 
35 54 0 0 0 0 0 0 0 0 0 0 0 0 0 0 52 54 0 118 119 120 119 120 119 120 119 120 119 121 0 0 52 53 53 53 35 53 53 53 
53 54 0 0 0 0 0 0 0 0 0 0 0 0 0 0 52 54 133 134 135 136 135 136 135 136 135 136 135 137 138 0 52 53 53 53 53 53 53 53 
53 54 96 97 98 0 0 96 97 98 0 0 0 0 0 0 52 54 149 150 151 152 151 152 151 152 151 152 152 153 154 0 52 53 53 53 53 53 53 53 
53 54 112 113 114 0 0 112 113 114 0 0 0 0 0 0 52 54 0 132 16 17 18 132 132 132 16 17 36 38 0 0 52 53 53 53 53 35 53 53 
53 54 0 129 0 0 0 0 129 0 0 0 0 0 0 0 52 54 0 132 32 0 34 132 132 132 32 0 52 54 0 0 52 53 69 69 69 69 69 53 
53 54 0 145 16 17 17 18 145 0 0 251 0 0 0 0 52 54 0 132 32 0 34 132 132 132 32 0 52 54 18 0 52 54 56 56 56 56 56 52 
53 53 37 37 37 37 37 37 37 37 37 37 38 0 0 0 52 54 0 16 17 18 34 132 132 132 32 0 52 54 34 0 52 54 56 56 56 56 56 52 
53 53 53 53 53 53 35 53 53 53 53 53 54 0 0 0 52 54 0 32 0 34 34 132 132 132 32 0 52 54 34 0 52 54 56 56 36 38 56 52 
53 53 35 53 53 53 53 53 53 53 53 53 54 0 0 0 52 54 0 32 0 20 17 17 17 17 18 0 52 54 34 16 68 70 56 56 52 54 56 52 
53 53 69 69 69 69 69 69 69 69 69 69 70 99 100 101 52 54 0 32 0 0 0 0 0 0 34 0 52 54 34 32 9 0 71 55 52 54 56 52 
53 54 0 0 0 99 100 101 0 0 99 100 101 115 116 117 52 54 0 32 0 0 0 0 0 251 34 0 52 54 34 32 9 251 0 71 52 54 56 52 
53 54 0 0 0 115 116 117 0 0 115 116 117 0 132 0 52 54 17 18 0 0 36 37 37 37 37 37 53 53 37 37 37 37 37 37 53 54 56 52 
53 54 0 16 18 0 132 0 16 17 18 132 0 251 132 0 52 54 0 34 0 0 52 53 53 53 53 53 53 53 53 53 35 53 53 53 53 54 56 52 
35 54 0 32 34 0 132 0 32 0 34 132 0 36 37 37 53 54 0 34 0 16 52 53 35 53 53 53 53 53 53 53 53 53 53 53 53 54 56 52 
53 54 17 18 34 0 16 17 18 0 16 17 17 52 35 53 53 54 18 34 0 32 52 53 53 53 53 53 69 69 69 69 69 69 69 69 69 70 56 52 
53 54 0 34 34 0 32 0 34 0 32 0 0 52 53 53 53 54 34 34 0 32 52 53 53 53 53 54 99 100 101 0 0 0 0 0 9 0 71 52 
53 54 0 34 34 0 32 16 17 17 18 0 0 68 69 69 69 70 17 17 17 17 52 53 53 53 53 54 115 116 117 0 99 100 101 0 9 0 0 52 
53 54 0 16 17 18 32 32 0 0 34 0 0 9 0 9 0 0 0 251 0 0 52 53 53 53 53 54 18 132 0 251 115 116 117 16 17 17 17 52 
53 53 37 37 37 37 37 37 37 37 37 37 37 37 37 37 37 37 37 37 37 37 53 53 53 35 53 54 34 132 16 17 18 132 0 32 0 0 0 52 
53 53 53 35 53 53 53 53 53 53 53 53 53 35 53 53 53 53 53 53 53 53 53 53 53 53 53 54 34 132 32 0 34 132 0 32 0 0 0 52 
53 53 53 53 53 53 53 53 35 53 53 53 53 53 53 53 53 53 35 53 53 53 53 53 53 53 53 54 80 80 80 80 80 80 36 38 80 80 80 52 
53 53 69 69 69 69 69 69 69 69 69 69 69 69 69 69 69 53 53 69 69 69 69 69 53 53 53 53 37 37 37 37 37 37 53 54 81 81 81 52 
53 54 0 0 0 118 119 120 119 120 119 120 119 120 119 121 0 52 54 56 56 56 56 56 52 53 53 53 53 35 53 53 53 53 53 54 81 81 81 52 
53 54 0 0 133 134 135 136 135 136 135 136 135 136 135 137 138 52 54 56 56 56 56 56 52 53 53 53 53 53 53 53 53 53 53 54 81 81 81 52 
53 54 0 0 149 150 151 150 151 150 151 150 151 150 151 153 154 68 70 72 56 36 38 80 68 69 53 53 53 69 69 69 69 69 69 70 81 81 81 52 
53 54 39 40 36 38 132 132 132 132 16 17 17 18 132 132 0 0 0 0 55 52 54 81 81 81 52 53 54 81 81 81 81 81 81 81 81 81 81 52 
53 54 55 56 52 54 132 132 132 132 32 0 0 20 17 18 0 0 0 0 71 52 54 81 81 88 52 53 54 87 81 81 81 250 81 81 81 81 81 52 
35 54 56 56 52 54 17 17 17 17 18 0 0 0 0 34 0 0 0 0 0 52 54 81 81 81 68 69 70 81 81 81 36 37 37 37 37 37 37 53 
53 54 56 56 52 54 0 0 0 0 34 0 0 0 0 16 17 18 0 0 0 52 54 87 81 81 81 81 81 81 81 88 52 35 69 69 69 69 69 53 
53 54 56 56 52 54 18 0 0 0 34 0 0 251 16 17 17 17 18 0 251 52 54 81 81 81 81 81 81 81 81 81 52 54 56 56 56 56 56 52 
53 54 56 56 52 53 37 37 38 0 34 0 0 36 37 37 37 37 37 37 37 53 53 37 37 38 82 82 82 36 37 37 53 54 56 56 73 71 55 52 
53 54 56 56 68 69 69 69 69 37 37 37 37 53 53 35 53 53 53 53 53 53 53 35 53 53 37 37 37 53 53 53 53 54 56 57 0 251 55 52 
53 54 56 56 56 56 56 56 56 52 53 69 69 69 69 69 69 69 69 69 69 69 69 69 69 69 69 69 69 69 69 69 69 70 56 56 40 36 37 53 
53 54 56 56 56 255 56 56 56 52 54 56 56 56 56 56 56 56 56 56 56 56 56 56 56 56 56 56 56 56 56 56 56 56 56 56 56 52 53 53 
53 54 56 16 17 17 17 18 56 68 70 56 56 56 36 38 56 72 56 56 72 56 56 72 56 56 72 72 72 56 56 56 56 56 56 72 72 52 53 53 
53 54 56 32 0 251 0 34 56 56 56 56 56 56 52 54 73 251 71 73 86 71 73 86 71 73 86 0 251 71 72 36 37 37 38 86 86 52 35 53 
53 53 37 37 37 37 37 37 37 37 37 37 37 37 53 53 37 37 37 37 37 37 37 37 37 37 37 37 37 37 37 53 35 53 53 37 37 53 53 53 
LAYER1
0 0 0 0 0 0 0 0 0 0 0 0 0 0 0 0 0 0 0 0 0 0 0 0 0 0 0 0 0 0 0 0 0 0 0 0 0 0 0 0 
0 0 0 0 0 0 0 0 0 0 0 0 0 0 0 0 0 0 0 0 0 0 0 0 0 0 0 0 0 0 0 0 0 0 0 0 0 0 0 0 
0 0 0 0 0 0 0 0 0 0 0 0 0 0 0 0 0 0 0 0 0 0 0 0 0 0 0 0 0 0 0 0 0 0 0 0 0 0 0 0 
0 0 0 0 0 0 0 0 0 0 0 0 0 0 0 0 0 0 0 0 0 0 0 0 0 0 0 0 0 0 0 0 0 0 0 0 0 0 0 0 
0 0 0 0 0 0 0 0 0 0 0 0 0 0 0 0 0 0 0 0 0 0 0 0 0 0 0 0 0 0 0 0 0 0 0 0 0 0 0 0 
0 0 0 0 0 0 0 0 0 0 0 0 0 0 0 0 0 0 0 0 0 0 0 0 0 0 0 0 0 0 0 0 0 0 0 0 0 0 0 0 
0 0 0 0 0 0 0 0 0 0 0 0 0 0 0 0 0 0 0 0 0 0 0 0 0 0 0 0 0 0 0 0 0 0 0 0 0 0 0 0 
0 0 0 0 0 0 0 0 0 0 0 0 0 0 0 0 0 0 0 0 0 0 0 0 0 0 0 0 0 0 0 0 0 0 0 0 0 0 0 0 
0 0 0 0 0 0 0 0 0 0 0 0 0 0 0 0 0 0 0 0 0 0 0 0 0 0 0 0 0 0 0 0 0 0 15 30 15 15 30 0 
0 0 0 0 0 0 0 0 0 0 0 0 0 0 0 0 0 0 0 0 0 0 0 0 0 0 0 0 0 0 0 0 0 0 15 0 15 30 0 0 
0 0 0 0 0 0 0 0 0 0 0 0 0 0 0 0 0 0 0 0 0 0 0 0 0 0 0 0 0 0 0 0 0 0 30 0 0 0 0 0 
0 0 0 0 0 0 0 0 0 0 0 0 0 0 0 0 0 0 0 0 0 0 0 0 0 0 0 0 0 0 0 0 0 0 0 0 0 0 0 0 
0 0 0 0 0 0 0 0 0 0 0 0 0 0 0 0 0 0 0 0 0 0 0 0 0 0 0 0 0 0 0 0 0 30 0 0 0 0 0 0 
0 0 0 0 0 0 0 0 0 0 0 0 0 0 0 0 0 0 0 0 0 0 0 0 0 0 0 0 0 0 0 0 0 0 0 0 0 0 0 0 
0 0 0 0 0 0 0 0 0 0 0 0 0 0 0 0 0 0 0 0 0 0 0 0 0 0 0 0 0 0 0 0 0 0 0 0 0 0 0 0 
0 0 0 0 0 0 0 0 0 0 0 0 0 0 0 0 0 0 0 0 0 0 0 0 0 0 0 0 0 0 0 0 0 0 0 0 0 0 0 0 
0 0 0 0 0 0 0 0 0 0 0 0 0 0 0 0 0 0 0 0 0 0 0 0 0 0 0 0 0 0 0 0 0 0 0 0 0 0 0 0 
0 0 0 0 0 0 0 0 0 0 0 0 0 0 0 0 0 0 0 0 0 0 0 0 0 0 0 0 0 0 0 0 0 0 0 0 0 0 0 0 
0 0 0 0 0 0 0 0 0 0 0 0 0 0 0 0 0 0 0 0 0 0 0 0 0 0 0 0 15 0 0 15 30 0 15 0 0 15 0 0 
0 0 0 0 0 0 0 0 0 0 0 0 0 0 0 0 0 0 0 0 0 0 0 0 0 0 0 0 30 0 0 30 0 0 30 0 0 15 0 0 
0 0 0 0 0 0 0 0 0 0 0 0 0 0 15 0 15 30 0 0 0 0 0 0 0 0 0 0 0 0 0 0 0 0 0 0 0 0 0 0 
0 0 0 0 0 0 0 0 0 0 0 0 0 0 0 0 0 0 0 0 0 0 0 0 0 0 0 0 0 0 0 0 0 0 0 0 0 0 0 0 
0 0 0 0 0 0 0 0 0 0 0 0 0 0 0 0 0 0 0 0 0 0 0 0 0 0 0 0 0 0 0 0 0 0 0 0 0 0 0 0 
0 0 0 0 0 0 0 0 0 0 0 0 0 0 0 0 0 0 0 0 0 0 0 0 0 0 0 0 0 0 0 0 0 0 0 0 0 0 0 0 
0 0 0 0 0 0 0 0 0 0 0 0 0 0 0 0 0 0 0 0 0 0 0 0 0 0 0 0 0 0 0 0 0 0 0 0 0 0 0 0 
0 0 0 0 0 0 0 0 0 0 0 0 0 0 0 0 0 0 0 15 30 15 30 0 0 0 0 0 0 0 0 0 0 0 0 0 0 0 0 0 
0 0 0 0 0 0 0 0 0 0 0 0 0 0 0 0 0 0 0 30 0 15 0 0 0 0 0 0 0 0 0 0 0 0 0 0 0 0 0 0 
0 0 0 0 0 0 0 0 0 0 0 0 0 0 0 0 0 0 0 0 0 0 0 0 0 0 0 0 0 0 0 0 0 0 0 0 0 0 0 0 
0 0 0 0 0 0 0 0 0 0 0 0 0 0 0 0 0 15 30 0 0 0 0 0 0 0 0 0 0 0 0 0 0 0 0 0 0 0 0 0 
0 0 0 0 0 0 0 0 0 0 0 0 0 0 0 0 0 30 0 0 0 0 0 0 0 0 0 0 0 0 0 0 0 0 0 0 0 0 0 0 
0 0 0 0 0 0 0 0 0 0 0 0 0 0 0 0 0 0 0 0 0 0 0 0 0 0 0 0 0 0 0 0 0 0 0 0 0 0 0 0 
0 0 0 0 0 0 0 0 0 0 0 0 0 0 0 0 0 0 0 0 0 0 0 0 0 0 0 0 0 0 0 0 0 0 0 0 0 0 0 0 
0 0 0 0 0 0 0 0 0 0 0 0 0 0 0 0 0 0 0 0 0 0 0 0 0 0 0 0 0 0 0 0 0 0 15 15 0 30 15 0 
0 0 0 0 0 0 0 0 0 0 0 0 0 0 0 0 0 0 0 0 0 0 0 0 0 0 0 0 0 0 0 0 0 0 15 30 0 0 30 0 
0 0 0 0 0 0 0 0 0 0 0 0 0 0 0 0 0 0 0 0 0 0 0 0 0 0 0 0 0 0 0 0 0 0 30 0 0 0 0 0 
0 0 0 0 30 0 0 30 15 0 0 0 0 0 0 0 0 0 0 0 0 0 0 0 0 0 0 0 0 0 0 0 0 0 0 0 0 0 0 0 
0 0 0 0 0 0 0 0 30 0 0 15 0 0 15 30 0 0 15 0 0 15 30 0 15 0 30 0 0 0 30 0 15 30 0 0 0 0 0 0 
0 0 0 0 0 0 0 0 0 0 0 30 0 0 0 0 0 0 30 0 0 30 0 0 30 0 0 0 0 0 0 0 15 0 0 0 0 0 0 0 
0 0 0 0 0 0 0 0 0 30 15 0 0 0 0 0 0 0 0 0 0 0 0 0 0 0 0 0 0 0 0 0 0 0 0 0 0 0 0 0 
0 0 0 0 0 0 0 0 0 0 0 0 0 0 0 0 0 0 0 0 0 0 0 0 0 0 0 0 0 0 0 0 0 0 0 0 0 0 0 0 
OBJECTS:
#type, x, y, dir, group
-2 467 611 0 0
-1 610 545 1 0
2 192 433 1 0
4 259 480 1 0
1 160 529 1 0
3 96 465 1 0
6 432 498 1 0
