#This file was generated automatically, any extra lines will be overwritten
#Created by editor v0.0.1

NAME: A very nice name 
LAYER0_MAPTILESET: tileset01.bmp
LAYER0_SIZE: 40 40
LAYER1_MAPTILESET: tileset02.bmp
LAYER1_SIZE: 40 40
START: 35 29
EXIT: 18 5
NEXT: ./data/maps/map02.map
MAP:
LAYER0
53 69 69 69 69 69 69 69 69 69 69 69 35 53 69 69 69 69 69 69 69 69 69 69 69 69 69 69 69 69 69 69 69 69 69 69 69 69 69 53 
54 0 0 0 0 0 0 0 0 0 0 0 52 54 0 0 0 9 0 0 9 0 0 9 0 0 118 119 120 119 120 119 120 119 120 119 121 0 0 52 
54 17 18 0 0 16 17 36 38 0 0 0 52 54 0 0 0 9 0 0 9 0 0 9 0 133 134 135 136 135 136 135 136 135 136 135 137 138 0 52 
54 0 34 0 0 32 0 52 54 17 18 0 52 54 41 0 0 9 0 0 9 0 0 36 38 149 150 151 150 151 150 16 17 17 18 152 153 154 0 52 
54 0 16 17 17 18 0 52 54 0 16 17 52 54 56 36 38 17 17 17 36 38 40 52 54 0 132 16 17 17 17 19 0 0 34 132 132 0 0 52 
54 0 32 0 0 34 0 52 54 0 32 0 52 54 56 52 54 0 254 0 52 54 56 52 54 0 132 32 0 0 0 0 0 16 17 17 18 0 0 52 
54 17 18 0 0 16 17 52 54 18 32 0 52 54 56 68 70 17 17 17 68 70 56 52 54 0 132 32 0 0 0 0 0 32 0 0 34 0 0 52 
53 37 37 37 37 37 37 35 70 34 32 16 52 54 56 56 56 40 40 40 56 56 56 52 54 0 132 32 0 0 0 0 0 32 0 0 34 0 0 52 
53 35 69 69 69 69 69 70 73 34 32 32 52 53 37 37 37 37 37 37 37 37 37 53 54 17 17 17 17 18 0 0 16 17 17 17 18 86 86 52 
53 54 56 56 56 56 56 73 0 16 36 37 69 69 69 69 69 53 35 69 69 69 69 53 54 0 0 0 0 34 0 0 32 0 0 0 20 17 17 52 
53 54 56 56 56 56 57 0 0 32 68 70 56 56 56 56 56 68 70 56 56 56 56 52 54 18 0 0 0 34 0 0 32 0 0 0 0 0 0 52 
53 54 56 56 56 56 56 36 38 32 0 20 17 17 17 18 71 56 56 56 36 38 56 52 54 34 0 0 16 17 17 17 18 0 0 0 0 0 0 52 
35 54 17 17 17 17 17 52 53 37 37 37 37 37 37 37 37 37 37 37 53 54 56 52 54 34 86 86 32 0 0 0 20 17 18 0 0 0 0 52 
53 54 40 40 40 40 40 52 53 53 53 53 53 35 53 53 53 53 53 35 53 54 56 52 54 17 17 17 18 0 0 0 0 0 34 0 0 0 16 52 
53 54 17 17 17 17 17 52 53 35 53 53 53 53 53 53 53 53 53 53 53 54 56 52 54 0 0 0 34 0 0 0 0 0 34 0 0 16 17 52 
53 54 40 40 40 40 40 52 53 69 69 69 69 53 53 69 69 69 69 69 53 54 56 52 54 0 0 0 34 0 0 86 0 0 34 0 16 17 17 52 
53 54 17 17 17 17 17 52 54 56 56 56 56 68 70 56 56 56 56 56 68 70 56 52 54 0 0 0 34 0 16 17 17 18 34 0 32 0 0 52 
53 54 40 40 40 40 40 52 54 56 36 38 56 56 56 73 16 17 17 17 19 55 56 52 54 0 16 18 34 0 32 0 0 34 34 0 32 0 0 52 
35 53 37 37 38 56 56 52 54 56 52 53 37 37 37 37 37 37 37 37 37 37 37 53 70 0 32 34 34 0 32 0 0 34 34 0 32 0 0 52 
53 53 69 69 70 18 55 52 54 56 68 69 53 35 53 53 53 69 69 69 69 69 69 70 0 0 32 34 34 0 32 0 16 17 17 18 32 0 0 52 
53 54 0 9 0 34 55 52 54 56 72 73 68 53 53 53 70 0 0 0 0 0 0 0 0 0 16 17 18 0 32 0 32 0 0 34 32 16 17 52 
53 54 0 9 0 34 16 52 54 73 0 0 0 68 69 70 0 0 16 17 36 38 0 0 0 0 32 0 34 0 32 0 32 0 0 34 32 32 0 52 
53 54 0 9 36 38 17 68 70 0 0 0 0 0 0 0 0 16 17 36 53 54 18 0 0 0 32 0 34 0 32 0 32 0 0 20 17 18 0 52 
53 54 0 16 68 54 0 0 0 0 0 0 0 0 0 0 16 17 36 53 35 54 34 0 0 0 32 0 16 17 17 17 18 0 0 0 0 34 0 52 
53 54 0 32 55 68 37 37 37 37 37 38 0 0 0 86 36 37 53 53 53 53 37 37 37 37 37 37 37 37 37 37 37 37 37 37 37 37 37 53 
53 54 0 32 55 56 56 53 53 53 53 53 37 37 37 37 53 53 53 53 53 53 53 53 53 35 53 53 53 53 53 53 53 53 53 53 53 35 53 53 
53 54 0 32 16 17 52 35 53 53 53 53 53 53 53 53 53 53 53 53 35 53 53 53 53 53 53 53 53 53 53 53 53 53 53 53 53 53 53 53 
53 54 0 32 32 0 52 53 69 69 69 69 69 69 69 69 69 69 69 69 69 69 69 69 69 69 69 69 69 53 53 53 69 69 69 69 69 69 69 53 
53 54 86 32 32 0 52 54 0 0 0 0 0 0 0 0 0 0 0 0 0 0 0 0 0 0 0 0 0 52 53 54 0 0 9 0 0 9 0 52 
53 54 17 18 32 0 52 54 0 0 0 0 99 100 101 0 0 118 119 120 119 120 119 120 119 121 0 0 0 52 35 54 0 0 9 252 0 9 0 52 
35 54 0 34 32 0 52 54 0 16 17 18 115 116 117 0 133 134 135 136 135 136 135 136 135 137 138 0 0 52 53 54 0 0 16 17 18 9 0 52 
53 54 0 34 32 86 52 54 17 19 0 34 0 132 16 18 149 150 151 152 151 152 151 152 151 16 18 0 0 52 53 54 17 18 32 0 34 9 16 52 
53 54 0 34 16 17 68 70 0 0 0 34 0 132 32 34 0 132 132 132 16 18 132 132 132 32 34 0 0 52 53 54 0 34 16 18 34 9 32 52 
53 54 0 34 32 0 0 0 0 0 16 17 18 132 32 34 0 132 16 17 19 34 132 132 132 32 16 18 0 52 53 54 0 16 18 34 34 16 17 52 
53 54 0 34 32 0 0 0 0 0 32 0 34 132 32 34 0 132 32 0 0 34 132 132 132 36 38 34 0 52 35 54 17 17 17 17 17 18 0 52 
53 53 37 37 37 37 37 38 0 0 32 0 34 132 32 34 0 132 32 0 0 34 132 132 16 52 54 34 16 52 53 53 37 38 0 0 0 36 37 53 
53 35 53 53 53 53 53 54 0 0 32 0 34 132 16 18 0 132 16 18 0 34 132 16 17 52 54 34 32 68 69 69 69 70 0 16 17 52 53 53 
53 53 53 53 53 53 35 54 80 80 80 80 80 80 80 80 80 80 80 80 80 80 80 80 80 52 54 34 32 9 0 0 0 9 0 32 0 52 53 35 
53 53 53 53 53 53 53 54 82 81 81 81 82 81 81 82 81 81 81 81 82 81 82 81 81 52 54 17 18 9 0 0 0 16 17 18 0 52 53 53 
53 53 53 53 53 53 53 53 37 37 37 37 37 37 37 37 37 37 37 37 37 37 37 37 37 35 53 37 37 37 37 37 37 37 37 37 37 53 53 53 
LAYER1
0 0 0 0 0 0 0 0 0 0 0 0 0 0 0 0 0 0 0 0 0 0 0 0 0 0 0 0 0 0 0 0 0 0 0 0 0 0 0 0 
0 0 0 0 0 0 0 0 0 0 0 0 0 0 0 15 15 0 0 15 0 15 0 0 0 0 0 0 0 0 0 0 0 0 0 0 0 0 0 0 
0 0 0 0 0 0 0 0 0 0 0 0 0 0 0 15 30 0 0 15 0 15 0 0 0 0 0 0 0 0 0 0 0 0 0 0 0 0 0 0 
0 0 0 0 0 0 0 0 0 0 0 0 0 0 0 15 0 0 0 30 0 15 0 0 0 0 0 0 0 0 0 0 0 0 0 0 0 0 0 0 
0 0 0 0 0 0 0 0 0 0 0 0 0 0 0 0 0 0 0 0 0 0 0 0 0 0 0 0 0 0 0 0 0 0 0 0 0 0 0 0 
0 0 0 0 0 0 0 0 0 0 0 0 0 0 0 0 0 0 0 0 0 0 0 0 0 0 0 0 0 0 0 0 0 0 0 0 0 0 0 0 
0 0 0 0 0 0 0 0 0 0 0 0 0 0 0 0 0 0 0 0 0 0 0 0 0 0 0 0 0 0 0 0 0 0 0 0 0 0 0 0 
0 0 0 0 0 0 0 0 0 0 0 0 0 0 0 15 30 0 0 0 15 15 0 0 0 0 0 0 0 0 0 0 0 0 0 0 0 0 0 0 
0 0 0 0 0 0 0 0 0 0 0 0 0 0 0 0 0 0 0 0 0 0 0 0 0 0 0 0 0 0 0 0 0 0 0 0 0 0 0 0 
0 0 15 15 0 15 0 15 0 0 0 0 0 0 0 0 0 0 0 0 0 0 0 0 0 0 0 0 0 0 0 0 0 0 0 0 0 0 0 0 
0 0 15 15 0 30 0 15 0 0 0 0 0 0 0 0 0 0 0 0 0 0 0 0 0 0 0 0 0 0 0 0 0 0 0 0 0 0 0 0 
0 0 15 30 0 0 0 0 0 0 0 0 0 0 0 0 0 0 0 0 0 0 0 0 0 0 0 0 0 0 0 0 0 0 0 0 0 0 0 0 
0 0 0 0 0 0 0 0 0 0 0 0 0 0 0 0 0 0 0 0 0 0 0 0 0 0 0 0 0 0 0 0 0 0 0 0 0 0 0 0 
0 0 0 0 0 0 0 0 0 0 0 0 0 0 0 0 0 0 0 0 0 0 0 0 0 0 0 0 0 0 0 0 0 0 0 0 0 0 0 0 
0 0 0 0 0 0 0 0 0 0 0 0 0 0 0 0 0 0 0 0 0 0 0 0 0 0 0 0 0 0 0 0 0 0 0 0 0 0 0 0 
0 0 0 0 0 0 0 0 0 0 0 0 0 0 0 0 0 0 0 0 0 0 0 0 0 0 0 0 0 0 0 0 0 0 0 0 0 0 0 0 
0 0 0 0 0 0 0 0 0 0 0 0 0 0 0 0 0 0 0 0 0 0 0 0 0 0 0 0 0 0 0 0 0 0 0 0 0 0 0 0 
0 0 0 0 0 0 0 0 0 0 0 0 0 0 0 0 0 0 0 0 0 0 0 0 0 0 0 0 0 0 0 0 0 0 0 0 0 0 0 0 
0 0 0 0 0 0 0 0 0 0 0 0 0 0 0 0 0 0 0 0 0 0 0 0 0 0 0 0 0 0 0 0 0 0 0 0 0 0 0 0 
0 0 0 0 0 0 0 0 0 0 0 0 0 0 0 0 0 0 0 0 0 0 0 0 0 0 0 0 0 0 0 0 0 0 0 0 0 0 0 0 
0 0 15 0 15 0 0 0 0 0 0 0 0 0 0 0 0 0 0 0 0 0 0 0 0 0 0 0 0 0 0 0 0 0 0 0 0 0 0 0 
0 0 30 0 15 0 0 0 0 0 0 0 0 0 0 0 0 0 0 0 0 0 0 0 0 0 0 0 0 0 0 0 0 0 0 0 0 0 0 0 
0 0 0 0 0 0 0 0 0 0 0 0 0 0 0 0 0 0 0 0 0 0 0 0 0 0 0 0 0 0 0 0 0 0 0 0 0 0 0 0 
0 0 0 0 0 0 0 15 15 0 0 0 0 0 0 0 0 0 0 0 0 0 0 0 0 0 0 0 0 0 0 0 0 0 0 0 0 0 0 0 
0 0 0 0 15 0 0 0 0 0 0 0 0 0 0 0 0 0 0 0 0 0 0 0 0 0 0 0 0 0 0 0 0 0 0 0 0 0 0 0 
0 0 0 0 30 15 52 0 0 0 0 0 0 0 0 0 0 0 0 0 0 0 0 0 0 0 0 0 0 0 0 0 0 0 0 0 0 0 0 0 
0 0 0 0 0 0 0 0 0 0 0 0 0 0 0 0 0 0 0 0 0 0 0 0 0 0 0 0 0 0 0 0 0 0 0 0 0 0 0 0 
0 0 0 0 0 0 0 0 0 0 0 0 0 0 0 0 0 0 0 0 0 0 0 0 0 0 0 0 0 0 0 0 0 0 0 0 0 0 0 0 
0 0 0 0 0 0 0 0 0 0 0 0 0 0 0 0 0 0 0 0 0 0 0 0 0 0 0 0 0 0 0 0 15 15 0 0 30 0 15 0 
0 0 0 0 0 0 0 0 0 0 0 0 0 0 0 0 0 0 0 0 0 0 0 0 0 0 0 0 0 0 0 0 15 30 0 0 0 0 30 0 
0 0 0 0 0 0 0 0 0 0 0 0 0 0 0 0 0 0 0 0 0 0 0 0 0 0 0 0 0 0 0 0 15 0 0 0 0 0 0 0 
0 0 0 0 0 0 0 0 0 0 0 0 0 0 0 0 0 0 0 0 0 0 0 0 0 0 0 0 0 0 0 0 0 0 0 0 0 0 0 0 
0 0 0 0 0 0 0 0 0 0 0 0 0 0 0 0 0 0 0 0 0 0 0 0 0 0 0 0 0 0 0 0 0 0 0 0 0 0 0 0 
0 0 0 0 0 0 15 30 0 0 0 0 0 0 0 0 0 0 0 0 0 0 0 0 0 0 0 0 0 0 0 0 0 0 0 0 0 0 0 0 
0 0 0 0 0 0 15 0 0 0 0 0 0 0 0 0 0 0 0 0 0 0 0 0 0 0 0 0 0 0 0 0 0 0 0 0 0 0 0 0 
0 0 0 0 0 0 0 0 0 0 0 0 0 0 0 0 0 0 0 0 0 0 0 0 0 0 0 0 0 0 0 0 0 0 0 0 0 0 0 0 
0 0 0 0 0 0 0 0 0 0 0 0 0 0 0 0 0 0 0 0 0 0 0 0 0 0 0 0 0 0 0 0 0 0 0 0 0 0 0 0 
0 0 0 0 0 0 0 0 0 0 0 0 0 0 0 0 0 0 0 0 0 0 0 0 0 0 0 0 0 0 0 15 0 0 0 0 0 0 0 0 
0 0 0 0 0 0 0 0 0 0 0 0 0 0 0 0 0 0 0 0 0 0 0 0 0 0 0 0 0 0 0 15 0 0 0 0 0 0 0 0 
0 0 0 0 0 0 0 0 0 0 0 0 0 0 0 0 0 0 0 0 0 0 0 0 0 0 0 0 0 0 0 0 0 0 0 0 0 0 0 0 
OBJECTS:
#type, x, y, dir, group
1 288 113 1 0
-2 403 67 0 0
2 448 49 1 0
3 496 33 1 0
2 560 113 0 0
1 464 113 0 0
3 464 161 1 0
2 480 161 1 0
4 611 224 0 0
2 528 289 1 0
3 464 353 1 0
3 336 321 0 7
3 320 321 0 7
1 240 385 0 0
1 224 273 1 6
1 256 273 0 6
3 304 177 0 5
3 272 177 0 5
1 112 17 1 0
3 96 177 0 2
3 48 177 0 2
1 32 209 1 2
1 64 209 1 2
3 96 241 1 2
3 48 241 1 2
-2 115 371 0 0
-2 99 403 0 0
3 176 465 0 0
3 560 497 0 0
3 480 609 1 1
3 432 609 1 1
2 288 513 1 0
-1 56 96 1 0
