#This file was generated automatically, any extra lines will be overwritten
#Created by editor v0.0.1

NAME: A very nice name 
LAYER0_MAPTILESET: tileset01.bmp
LAYER0_SIZE: 40 40
LAYER1_MAPTILESET: tileset02.bmp
LAYER1_SIZE: 4 4
START: 1 2
EXIT: 8 2
NEXT: ./data/maps/map01.map
MAP:
LAYER0
0 0 0 0 0 0 0 0 0 0 0 0 0 0 52 53 53 53 53 53 53 35 0 0 0 0 0 0 0 0 0 0 0 0 0 0 0 0 0 0 
0 0 0 0 0 0 0 0 0 0 0 0 0 0 52 53 53 53 53 53 53 53 0 0 0 0 0 0 0 0 0 0 0 0 0 0 0 0 0 0 
0 0 0 0 0 0 0 0 254 0 16 17 17 17 52 53 53 53 35 53 53 53 0 0 0 0 0 0 0 0 0 0 0 0 0 0 0 0 0 0 
0 0 0 0 0 0 16 17 17 17 19 0 0 0 52 53 53 53 53 53 53 53 0 0 0 0 0 0 0 0 0 0 0 0 0 0 0 0 0 0 
2 2 3 0 0 0 32 1 2 2 2 2 2 2 52 53 53 53 53 53 53 53 53 53 53 53 53 53 53 53 53 53 53 53 53 53 53 53 53 53 
37 37 38 0 0 36 37 37 37 37 37 37 37 37 53 53 53 53 53 53 53 53 53 53 53 53 53 53 53 53 53 53 53 53 53 35 53 53 53 53 
53 53 54 41 39 68 69 69 69 69 53 53 53 53 53 35 53 53 53 53 53 53 53 53 53 53 35 53 53 53 53 53 53 53 53 53 53 53 53 35 
53 53 54 56 56 56 56 56 56 56 52 35 53 53 53 69 69 69 69 69 69 69 69 69 69 69 69 69 69 69 69 69 69 69 69 69 69 69 69 53 
53 53 54 71 56 56 56 56 72 73 52 53 53 53 54 0 0 0 0 0 0 0 0 0 0 0 0 0 0 0 0 0 0 0 0 0 39 56 56 52 
53 53 53 37 37 37 37 38 0 0 52 53 35 53 54 0 0 0 0 0 118 119 120 119 120 119 120 119 120 119 120 119 121 0 0 39 56 56 56 52 
35 53 53 53 53 53 53 54 39 40 68 69 69 69 70 0 16 17 18 133 134 135 134 135 134 135 134 135 134 135 134 135 137 138 36 37 38 56 56 52 
53 53 53 53 53 35 53 54 56 56 56 41 39 56 41 0 32 0 34 115 150 151 152 151 152 151 152 151 152 151 152 151 153 16 52 53 54 56 56 52 
53 53 53 53 53 53 53 54 56 56 56 56 56 56 57 41 32 0 34 1 148 132 132 132 146 148 16 18 132 132 132 132 132 32 52 53 54 56 56 52 
53 53 53 53 53 53 53 53 37 37 37 37 37 37 38 56 32 16 17 17 18 132 132 132 16 17 19 34 132 132 132 132 132 16 52 53 54 73 71 52 
53 53 35 53 53 53 53 53 53 53 53 53 53 53 54 17 17 18 0 0 34 132 132 132 32 0 0 34 132 132 132 132 148 32 52 53 54 0 0 52 
53 53 53 53 53 53 53 53 53 53 35 53 53 53 54 0 0 34 0 0 34 132 132 132 32 16 17 18 132 132 132 132 16 17 52 35 54 39 40 52 
0 0 0 0 0 0 0 53 53 53 53 53 53 53 54 80 80 80 80 80 80 80 80 80 80 80 80 80 80 80 80 80 80 80 52 53 54 56 56 52 
0 0 0 0 0 0 0 53 53 53 53 53 53 53 54 82 81 81 81 82 81 81 81 81 82 81 81 81 81 82 81 82 81 81 52 53 54 56 56 52 
0 0 0 0 0 0 0 53 53 53 53 53 53 35 53 37 37 37 37 37 37 37 37 37 37 37 37 37 37 37 37 37 37 37 53 53 54 56 56 52 
0 0 0 0 0 0 0 53 53 53 53 53 53 53 53 53 53 53 53 53 53 35 53 53 53 53 53 53 35 53 53 53 53 35 53 53 54 56 56 52 
0 0 0 0 0 0 0 0 0 0 0 0 0 0 0 0 0 0 0 0 0 0 0 0 69 69 69 69 69 69 69 69 69 69 69 69 70 71 56 52 
0 0 0 0 0 0 0 0 0 0 0 0 0 0 0 0 0 0 0 0 0 0 0 0 0 0 0 0 0 0 0 0 0 0 0 0 0 0 55 52 
0 0 0 0 0 0 0 0 0 0 0 0 0 0 0 0 0 0 0 0 0 0 0 0 0 0 0 0 0 0 0 0 0 0 0 0 0 0 55 52 
0 0 0 0 0 0 0 0 0 0 0 0 0 0 0 0 0 0 0 0 0 0 0 0 0 0 0 0 0 0 0 0 0 0 0 0 0 0 55 52 
0 0 0 0 0 0 0 0 0 0 0 0 0 0 0 0 0 0 0 0 0 0 0 0 0 0 0 0 0 0 0 0 0 0 0 0 0 0 55 52 
0 0 0 0 0 0 0 0 0 0 0 0 0 0 0 0 0 0 0 0 0 16 17 17 18 0 0 0 16 17 18 0 0 0 0 0 0 16 17 52 
0 0 0 0 0 0 0 0 0 0 0 0 0 0 0 0 0 0 0 0 36 37 38 17 36 38 17 17 19 0 34 0 0 16 17 17 17 18 0 52 
0 0 0 0 0 0 0 0 0 0 0 0 0 0 0 0 0 0 0 36 53 35 54 40 52 54 0 0 0 0 34 0 0 32 36 38 0 34 0 52 
0 0 0 0 0 0 0 0 0 0 0 16 17 17 18 0 0 0 36 53 53 53 54 17 52 54 0 0 0 0 34 0 0 32 52 54 18 34 0 52 
0 0 0 0 0 0 0 0 0 0 0 32 0 36 37 37 37 37 53 53 53 53 54 40 52 54 0 0 0 0 34 0 0 32 52 53 37 38 86 52 
0 0 0 0 0 0 0 0 0 0 16 17 17 52 0 53 53 53 53 53 53 53 54 17 52 54 0 0 0 0 34 0 0 86 52 53 53 53 37 53 
0 0 0 0 0 16 17 17 18 0 32 0 0 52 0 0 53 53 53 53 53 53 54 40 52 54 0 0 0 0 34 0 0 36 53 53 53 35 53 53 
0 0 0 0 0 32 0 36 37 37 37 37 37 53 0 0 53 53 53 35 53 53 54 17 68 70 0 0 0 0 34 0 0 68 69 69 69 69 69 53 
0 0 0 0 16 17 17 52 0 0 0 0 0 0 0 0 0 53 53 53 53 53 54 40 56 57 0 0 0 0 34 0 0 0 55 56 56 56 56 52 
0 0 0 0 32 0 0 52 0 0 0 0 0 0 0 0 0 53 53 53 53 53 54 19 55 57 0 0 0 0 34 0 0 0 36 37 37 38 80 52 
0 0 0 0 32 36 37 35 0 0 0 0 0 0 0 0 0 53 53 53 53 35 54 86 36 38 86 86 86 86 86 86 86 36 69 69 53 54 81 52 
0 0 0 0 0 0 0 0 0 0 0 0 0 0 0 0 0 53 53 53 53 53 53 37 53 53 37 37 37 37 37 37 37 54 73 71 52 54 81 52 
0 0 0 0 0 0 0 0 0 0 0 0 0 0 0 0 52 53 53 53 53 53 53 53 53 53 53 53 53 53 53 35 53 53 38 80 68 70 81 52 
0 0 0 0 0 0 0 0 0 0 0 0 0 0 0 0 52 53 53 53 53 53 53 53 53 53 53 53 35 53 53 53 53 53 54 81 81 81 81 52 
0 0 0 0 0 0 0 0 0 0 0 0 37 37 37 37 53 35 53 53 53 53 53 53 53 53 53 53 53 53 53 53 53 35 53 37 37 37 37 53 
LAYER1
0 1 2 3 
4 5 6 7 
8 9 10 11 
12 13 14 15 
OBJECTS:
-1 192 32 0
4 140 0 0
3 30 3 0
2 434 500 1
1 456 20 1
2 60 50 1
1 49 20 1
0 50 10 15
2 100 50 15
1 90 20 15
0 80 10 15
2 70 50 15
1 60 20 15
0 90 10 15
2 80 50 15
1 70 20 15
0 60 10 15
2 40 50 15
1 20 20 15
