#This file was generated automatically, any extra lines will be overwritten
#Created by editor v0.0.1

NAME: Jungle demo 
LAYER0_MAPTILESET: tileset01.bmp
LAYER0_SIZE: 84 10
LAYER1_MAPTILESET: tileset02.bmp
LAYER1_SIZE: 0 0
START: 1 2
EXIT: 2 2
NEXT: ./data/maps/demo01.map
MAP:
LAYER0
0 0 0 0 0 0 0 0 0 0 0 0 0 0 0 0 0 0 0 0 0 0 0 0 0 0 0 0 0 0 0 0 0 0 0 0 0 0 0 0 0 0 0 0 0 0 0 0 0 0 0 0 0 0 0 0 0 0 0 0 0 0 0 0 0 0 0 0 0 0 0 0 0 0 0 0 0 0 0 0 0 0 0 0 
0 0 0 8 0 0 0 0 0 0 0 0 0 0 0 0 8 0 0 0 0 0 0 0 0 0 0 0 0 0 0 0 0 0 0 0 0 0 0 0 0 0 0 0 0 0 0 0 0 0 0 0 0 0 0 0 0 0 0 0 0 0 0 0 0 0 0 0 0 0 0 0 0 0 0 0 0 8 0 0 0 0 0 0 
0 0 0 0 0 0 0 0 8 0 0 0 0 0 0 0 0 0 0 0 0 0 0 8 0 0 0 0 0 0 0 0 0 0 0 0 0 0 0 0 0 0 0 0 0 0 0 0 0 0 0 0 0 0 0 0 0 0 0 0 0 0 0 0 0 0 0 0 0 0 0 0 0 0 0 0 0 0 0 0 0 0 8 0 
0 0 0 0 0 0 0 0 0 0 0 0 0 0 0 0 0 0 0 0 0 0 0 0 0 0 0 0 0 0 0 0 0 0 0 0 0 0 0 0 0 0 0 0 0 0 0 0 0 0 0 0 0 0 0 0 0 0 0 0 0 0 0 0 0 0 0 0 0 0 0 0 0 0 0 0 0 0 0 0 0 0 0 0 
0 0 0 0 0 0 0 0 0 0 0 0 0 0 0 0 0 0 0 0 0 0 0 0 0 0 0 0 1 2 3 0 0 0 0 0 0 0 0 0 0 0 0 0 0 0 0 0 0 0 0 0 0 0 0 0 0 0 0 0 0 0 0 0 0 0 0 0 0 0 0 0 0 0 0 0 0 0 0 0 0 0 0 0 
0 0 0 0 0 0 0 0 0 0 0 0 16 17 17 17 18 0 0 0 0 0 0 0 0 0 0 0 16 17 18 0 0 0 0 0 0 0 0 0 0 0 0 1 2 3 0 0 0 0 0 0 0 0 0 0 0 0 0 0 1 2 2 2 3 0 0 0 0 0 0 0 0 0 0 0 0 0 0 0 0 0 0 0 
2 3 0 0 0 0 0 0 1 2 2 2 32 0 0 0 34 2 2 3 0 0 0 1 2 2 3 16 17 17 17 18 0 0 16 18 0 16 18 0 16 18 0 16 17 18 2 2 2 16 18 0 0 0 0 0 0 0 0 0 16 17 17 17 18 0 0 0 0 0 0 0 0 0 0 0 0 0 0 0 0 0 1 2 
17 18 0 0 0 0 0 0 16 17 17 17 17 17 17 17 17 17 17 18 0 0 0 16 17 17 17 17 17 17 17 17 17 17 19 67 80 66 67 80 66 67 80 66 0 20 17 17 17 19 34 0 96 97 98 0 96 97 98 0 32 0 0 0 20 17 18 0 0 0 0 0 0 0 0 0 0 0 0 0 0 0 16 17 
0 20 17 17 17 17 17 17 19 0 0 0 0 0 0 0 0 0 0 67 80 80 80 66 0 0 0 0 0 0 0 0 0 0 0 67 82 66 67 82 66 67 82 66 0 0 0 0 0 0 34 0 112 113 114 0 112 113 114 0 32 0 0 0 0 0 20 17 18 80 80 80 16 18 80 80 80 16 17 17 17 17 19 0 
0 0 0 0 0 0 0 0 0 0 0 0 0 0 0 0 0 0 0 83 84 84 84 85 0 0 0 0 0 0 0 0 0 0 0 83 84 85 83 84 85 83 84 85 0 0 0 0 0 0 34 0 0 129 0 0 0 129 0 0 32 0 0 0 0 0 0 0 67 82 82 82 66 67 82 82 82 66 0 0 0 0 0 0 
LAYER1
OBJECTS:
