#This file was generated automatically, any extra lines will be overwritten
#Created by editor v0.0.1

NAME: A very nice name 
LAYER0_MAPTILESET: tileset01.bmp
LAYER0_SIZE: 40 40
LAYER1_MAPTILESET: tileset02.bmp
LAYER1_SIZE: 40 40
START: 2 1
EXIT: 37 35
NEXT: ./data/maps/map02.map
MAP:
LAYER0
53 69 69 69 53 53 53 35 53 53 53 69 69 69 69 69 69 69 69 69 69 53 35 69 69 69 69 69 69 69 69 69 69 53 53 69 69 69 53 53 
54 56 253 56 52 53 53 53 53 53 54 0 0 0 0 0 0 0 0 0 0 52 54 9 0 0 9 0 0 0 0 0 0 52 54 73 71 55 52 53 
54 72 72 73 52 35 53 53 53 53 54 41 0 0 0 0 0 0 16 17 17 52 54 9 0 0 9 0 0 0 0 0 0 52 54 0 0 55 52 35 
54 0 0 0 52 53 53 53 53 35 54 56 40 40 41 0 0 0 32 0 0 52 54 9 0 36 37 38 0 0 0 0 0 52 54 41 39 73 52 53 
54 0 0 0 68 69 69 69 69 69 70 71 55 36 37 38 0 36 37 38 39 52 54 18 0 52 53 54 17 17 17 18 0 52 53 38 57 39 52 53 
54 0 0 0 0 0 0 0 0 0 0 0 71 68 53 54 40 68 69 70 56 52 54 34 0 52 35 70 0 0 0 34 0 52 53 70 56 57 52 35 
54 0 0 0 0 0 0 0 0 0 0 0 0 0 52 54 56 56 56 56 56 52 54 34 0 52 54 0 0 0 16 17 36 53 54 56 56 56 52 53 
54 0 0 0 0 0 0 16 17 17 17 18 0 0 52 35 37 38 56 36 37 53 54 34 0 52 54 0 0 0 32 0 52 35 54 56 56 73 52 53 
54 17 17 18 0 0 0 32 0 0 0 34 0 0 52 53 53 54 56 52 53 53 70 34 16 52 54 0 16 17 18 0 52 53 54 56 57 86 52 53 
54 0 0 34 0 16 17 17 18 0 0 34 0 0 52 53 53 54 56 52 35 54 0 34 32 52 54 0 32 0 34 0 52 53 54 56 56 36 53 53 
54 0 0 16 17 17 17 17 17 18 0 34 0 0 52 53 35 70 56 68 53 54 17 18 32 52 54 0 32 0 34 0 52 53 54 56 56 52 35 53 
54 0 0 32 0 0 0 0 0 34 0 34 0 0 52 53 54 72 72 73 52 54 0 34 32 52 54 18 32 0 16 17 52 53 54 56 56 68 53 53 
54 0 0 32 0 0 16 18 0 34 0 34 0 0 52 53 54 0 0 0 52 54 0 34 32 52 54 34 32 0 32 0 52 53 54 56 56 41 52 53 
54 86 86 32 0 0 32 34 0 34 0 34 86 86 52 53 54 80 80 80 52 54 80 36 37 53 54 34 16 17 17 17 52 53 54 72 56 56 52 53 
53 37 37 37 37 37 37 37 37 37 37 37 37 37 35 53 54 81 81 81 68 70 81 52 53 35 54 34 32 0 0 0 52 35 54 86 55 56 52 53 
53 53 53 53 53 53 35 53 53 53 53 53 53 53 53 53 54 81 81 81 81 81 81 52 53 69 70 34 32 0 0 0 52 53 53 38 56 56 52 53 
53 53 69 69 69 69 69 69 69 69 69 69 69 69 69 53 54 81 81 81 81 81 81 52 54 0 0 34 32 0 0 0 68 69 69 70 56 56 52 35 
53 54 0 0 0 0 0 0 0 0 0 0 0 0 0 52 35 37 37 37 37 37 37 53 54 0 0 34 32 0 0 0 55 56 56 56 56 56 52 53 
35 54 17 18 0 0 0 16 17 17 17 17 18 0 0 68 69 69 69 69 69 69 53 35 70 0 16 17 18 0 0 0 55 56 56 56 56 56 52 53 
53 54 0 20 18 0 16 17 17 17 18 0 34 0 0 0 0 0 9 0 0 9 68 70 0 0 32 16 17 17 36 37 37 37 37 37 37 37 53 53 
53 54 0 16 17 17 36 38 17 17 17 17 17 18 0 0 0 0 9 0 0 9 0 0 0 0 32 32 0 0 52 53 35 53 53 53 53 53 53 53 
53 54 0 32 0 0 52 54 17 17 17 18 0 34 0 0 0 0 36 38 0 9 0 0 0 0 32 32 0 0 52 53 53 53 53 53 53 53 53 53 
35 53 37 38 0 0 52 53 37 37 37 37 37 37 37 37 37 37 35 53 37 37 37 37 37 37 37 37 38 17 52 53 53 53 53 53 35 53 53 53 
53 53 69 70 0 0 68 69 69 69 69 69 69 69 69 69 69 69 69 69 69 69 69 69 69 69 69 69 70 0 52 53 53 53 53 53 53 53 53 53 
53 54 0 0 0 0 0 0 0 0 0 0 118 119 120 119 120 119 120 119 120 119 120 119 120 121 0 0 0 16 52 53 53 69 69 69 69 69 69 35 
53 54 0 0 0 0 0 0 0 0 133 134 135 136 135 136 135 136 135 136 135 136 135 136 135 137 138 16 17 17 52 35 54 56 56 56 56 56 56 52 
53 54 96 97 98 0 0 16 17 18 149 150 151 150 151 150 151 150 16 18 150 151 150 152 151 152 16 17 17 17 52 53 54 72 72 56 56 56 56 52 
53 54 112 113 114 0 0 32 0 34 0 132 132 16 17 17 17 17 19 34 132 132 132 132 132 132 32 0 0 0 52 53 54 0 0 55 56 56 56 52 
35 54 0 129 0 0 0 32 0 34 0 132 132 32 0 0 0 0 0 20 17 18 132 132 132 132 32 0 0 0 52 53 54 80 80 36 37 38 56 52 
53 54 0 129 0 0 0 32 16 17 18 132 16 19 0 0 0 0 0 0 0 34 132 16 17 17 18 0 0 0 52 53 54 87 81 52 53 54 56 52 
53 54 0 129 0 0 0 32 32 0 34 132 32 0 0 0 0 0 0 0 0 16 17 17 17 18 34 0 0 0 52 35 54 81 81 52 53 54 56 52 
53 54 0 129 36 38 0 32 36 38 34 132 36 38 0 0 36 38 0 0 36 37 38 17 36 37 37 38 80 80 52 53 54 81 81 52 53 54 56 52 
53 54 0 129 52 54 0 32 52 54 34 132 52 54 0 0 52 54 0 0 52 53 54 41 52 53 53 54 87 81 52 53 54 81 88 52 53 54 56 52 
53 54 0 129 52 54 0 32 52 54 34 132 52 54 0 0 52 54 0 0 52 53 54 17 52 53 35 54 81 81 52 53 54 81 81 52 53 70 71 52 
35 54 0 129 52 54 0 32 52 54 34 132 52 54 0 0 52 54 0 0 52 35 54 40 52 53 53 54 81 81 52 53 54 81 81 52 54 0 0 52 
53 54 86 86 52 54 86 86 52 54 34 132 52 54 86 86 52 54 86 86 52 53 54 17 52 53 53 54 81 88 68 69 70 87 81 52 54 254 0 52 
53 53 37 37 53 53 37 37 53 54 34 132 52 53 37 37 53 53 37 37 53 53 54 40 52 53 53 54 81 81 81 81 81 81 81 52 54 18 0 52 
53 53 35 53 53 53 53 53 69 70 34 132 68 69 69 69 69 69 69 69 69 69 70 17 52 35 53 54 81 81 81 82 81 81 81 52 53 38 86 52 
53 53 53 53 53 53 53 54 56 57 34 148 3 55 56 56 56 56 56 56 56 56 56 40 52 53 53 53 37 37 37 37 37 37 37 53 53 53 37 53 
53 53 53 53 53 53 53 53 37 37 37 37 37 37 37 37 37 37 37 37 37 37 37 37 53 53 53 53 53 53 53 53 35 53 53 53 53 53 35 53 
LAYER1
0 0 0 0 0 0 0 0 0 0 0 0 0 0 0 0 0 0 0 0 0 0 0 0 0 0 0 0 0 0 0 0 0 0 0 0 0 0 0 0 
0 0 0 0 0 0 0 0 0 0 0 0 30 15 0 0 0 0 0 0 0 0 0 0 0 15 0 30 0 0 0 0 0 0 0 0 0 0 0 0 
0 0 0 0 0 0 0 0 0 0 0 0 0 30 0 0 0 0 0 0 0 0 0 0 0 30 0 0 0 0 0 0 0 0 0 0 0 0 0 0 
0 0 0 0 0 0 0 0 0 0 0 0 0 0 0 0 0 0 0 0 0 0 0 0 0 0 0 0 0 0 0 0 0 0 0 0 0 0 0 0 
0 0 0 0 0 0 0 0 0 0 0 0 0 0 0 0 0 0 0 0 0 0 0 0 0 0 0 0 0 0 0 0 0 0 0 0 0 0 0 0 
0 0 0 0 0 0 0 0 0 0 0 0 0 0 0 0 0 0 0 0 0 0 0 0 0 0 0 0 0 0 0 0 0 0 0 0 0 0 0 0 
0 0 0 0 0 0 0 0 0 0 0 0 0 0 0 0 0 0 0 0 0 0 0 0 0 0 0 0 0 0 0 0 0 0 0 0 0 0 0 0 
0 0 0 0 0 0 0 0 0 0 0 0 0 0 0 0 0 0 0 0 0 0 0 0 0 0 0 0 0 0 0 0 0 0 0 0 0 0 0 0 
0 0 0 0 0 0 0 0 0 0 0 0 0 0 0 0 0 0 0 0 0 0 0 0 0 0 0 0 0 0 0 0 0 0 0 0 0 0 0 0 
0 0 0 0 0 0 0 0 0 0 0 0 0 0 0 0 0 0 0 0 0 0 0 0 0 0 0 0 0 0 0 0 0 0 0 0 0 0 0 0 
0 0 0 0 0 0 0 0 0 0 0 0 0 0 0 0 0 0 0 0 0 0 0 0 0 0 0 0 0 0 0 0 0 0 0 0 0 0 0 0 
0 0 0 0 0 0 0 0 0 0 0 0 0 0 0 0 0 0 0 0 0 0 0 0 0 0 0 0 0 0 0 0 0 0 0 0 0 0 0 0 
0 0 0 0 0 0 0 0 0 0 0 0 0 0 0 0 0 0 0 0 0 0 0 0 0 0 0 0 0 0 0 0 0 0 0 0 0 0 0 0 
0 0 0 0 0 0 0 0 0 0 0 0 0 0 0 0 0 0 0 0 0 0 0 0 0 0 0 0 0 0 0 0 0 0 0 0 0 0 0 0 
0 0 0 0 0 0 0 0 0 0 0 0 0 0 0 0 0 0 0 0 0 0 0 0 0 0 0 0 0 0 0 0 0 0 0 0 0 0 0 0 
0 0 0 0 0 0 0 0 0 0 0 0 0 0 0 0 0 0 0 0 0 0 0 0 0 0 0 0 0 0 0 0 0 0 0 0 0 0 0 0 
0 0 0 0 0 0 0 0 0 0 0 0 0 0 0 0 0 0 0 0 0 0 0 0 0 15 15 0 0 0 0 0 0 0 0 0 0 0 0 0 
0 0 0 0 0 0 0 0 0 0 0 0 0 0 0 0 0 0 0 0 0 0 0 0 0 15 15 0 0 0 0 0 0 0 0 0 0 0 0 0 
0 0 0 0 0 0 0 0 0 0 0 0 0 0 0 0 0 0 0 0 0 0 0 0 0 15 0 0 0 0 0 0 0 0 0 0 0 0 0 0 
0 0 0 0 0 0 0 0 0 0 0 0 0 0 0 0 15 0 0 15 0 0 0 0 0 30 0 0 0 0 0 0 0 0 0 0 0 0 0 0 
0 0 0 0 0 0 0 0 0 0 0 0 0 0 0 0 30 0 0 15 0 0 15 30 0 0 0 0 0 0 0 0 0 0 0 0 0 0 0 0 
0 0 0 0 0 0 0 0 0 0 0 0 0 0 0 0 0 0 0 0 0 0 15 0 0 0 0 0 0 0 0 0 0 0 0 0 0 0 0 0 
0 0 0 0 0 0 0 0 0 0 0 0 0 0 0 0 0 0 0 0 0 0 0 0 0 0 0 0 0 0 0 0 0 0 0 0 0 0 0 0 
0 0 0 0 0 0 0 0 0 0 0 0 0 0 0 0 0 0 0 0 0 0 0 0 0 0 0 0 0 0 0 0 0 0 0 0 0 0 0 0 
0 0 0 0 0 0 0 0 0 0 0 0 0 0 0 0 0 0 0 0 0 0 0 0 0 0 0 0 0 0 0 0 0 0 0 0 0 0 0 0 
0 0 0 0 0 0 0 0 0 0 0 0 0 0 0 0 0 0 0 0 0 0 0 0 0 0 0 0 0 0 0 0 0 0 0 0 0 0 0 0 
0 0 0 0 0 0 0 0 0 0 0 0 0 0 0 0 0 0 0 0 0 0 0 0 0 0 0 0 0 0 0 0 0 0 0 0 0 0 0 0 
0 0 0 0 0 0 0 0 0 0 0 0 0 0 0 0 0 0 0 0 0 0 0 0 0 0 0 0 0 0 0 0 0 0 0 0 0 0 0 0 
0 0 0 0 0 0 0 0 0 0 0 0 0 0 0 0 0 0 0 0 0 0 0 0 0 0 0 0 0 0 0 0 0 0 0 0 0 0 0 0 
0 0 0 0 0 0 0 0 0 0 0 0 0 0 0 0 0 0 0 0 0 0 0 0 0 0 0 0 0 0 0 0 0 0 0 0 0 0 0 0 
0 0 0 0 0 0 0 0 0 0 0 0 0 0 0 0 0 0 0 0 0 0 0 0 0 0 0 0 0 0 0 0 0 0 0 0 0 0 0 0 
0 0 0 0 0 0 0 0 0 0 0 0 0 0 0 0 0 0 0 0 0 0 0 0 0 0 0 0 0 0 0 0 0 0 0 0 0 0 0 0 
0 0 0 0 0 0 0 0 0 0 0 0 0 0 0 0 0 0 0 0 0 0 0 0 0 0 0 0 0 0 0 0 0 0 0 0 0 0 0 0 
0 0 0 0 0 0 0 0 0 0 0 0 0 0 0 0 0 0 0 0 0 0 0 0 0 0 0 0 0 0 0 0 0 0 0 0 0 0 0 0 
0 0 0 0 0 0 0 0 0 0 0 0 0 0 0 0 0 0 0 0 0 0 0 0 0 0 0 0 0 0 0 0 0 0 0 0 0 0 0 0 
0 0 0 0 0 0 0 0 0 0 0 0 0 0 0 0 0 0 0 0 0 0 0 0 0 0 0 0 0 0 0 0 0 0 0 0 0 0 0 0 
0 0 0 0 0 0 0 0 0 0 0 0 0 0 0 0 0 0 0 0 0 0 0 0 0 0 0 0 0 0 0 0 0 0 0 0 0 0 0 0 
0 0 0 0 0 0 0 0 0 0 0 0 0 0 0 0 0 0 0 0 0 0 0 0 0 0 0 0 0 0 0 0 0 0 0 0 0 0 0 0 
0 0 0 0 0 0 0 0 30 0 0 0 0 0 30 15 0 0 15 30 15 0 30 0 0 0 0 0 0 0 0 0 0 0 0 0 0 0 0 0 
0 0 0 0 0 0 0 0 0 0 0 0 0 0 0 0 0 0 0 0 0 0 0 0 0 0 0 0 0 0 0 0 0 0 0 0 0 0 0 0 
OBJECTS:
#type, x, y, dir, group
1 144 97 0 0
1 144 145 1 0
1 208 49 1 0
3 304 17 1 1
1 320 17 1 1
4 387 192 0 0
3 464 49 1 0
1 496 49 1 0
3 480 113 1 0
2 496 193 1 0
3 592 289 1 0
-1 562 49 1 0
-2 595 19 1 0
3 448 337 1 0
-2 467 371 1 0
1 320 337 1 0
2 288 321 1 0
4 243 336 1 0
3 192 305 1 0
1 192 273 1 0
1 144 289 1 0
3 128 321 1 0
2 48 305 1 0
2 144 401 1 0
2 256 417 1 0
3 304 401 1 0
4 275 480 1 2
4 259 480 1 2
2 320 433 1 0
2 384 465 1 0
2 400 449 1 0
3 464 401 1 0
3 464 385 1 0
4 579 432 1 0
1 208 609 1 0
-2 131 611 1 0
