#This file was generated automatically, any extra lines will be overwritten
#Created by editor v0.0.1

NAME: A very nice name 
LAYER0_MAPTILESET: tileset01.bmp
LAYER0_SIZE: 40 40
LAYER1_MAPTILESET: tileset02.bmp
LAYER1_SIZE: 40 40
START: 20 38
EXIT: 34 5
NEXT: ./data/maps/map02.map
MAP:
LAYER0
53 53 35 53 53 53 53 53 53 35 53 53 53 54 0 0 0 0 0 0 0 0 0 0 0 0 0 0 0 45 62 62 62 62 62 62 44 62 62 62 
53 69 69 69 69 69 69 69 69 69 69 69 53 54 0 0 0 0 0 8 0 0 0 0 0 8 0 0 45 44 62 62 62 62 62 62 62 62 62 62 
54 56 56 56 56 56 56 56 56 56 56 56 52 54 0 8 0 0 0 0 0 8 0 0 0 0 0 45 62 62 62 62 78 78 78 78 78 62 62 62 
54 56 56 56 56 56 56 56 16 17 17 17 52 54 0 0 0 0 0 0 0 0 0 91 94 92 92 77 62 62 62 79 108 108 108 108 108 77 62 62 
54 56 56 16 17 17 17 17 19 0 0 0 52 54 0 0 0 0 0 0 0 91 94 108 108 108 108 108 77 78 79 108 108 108 108 108 108 108 61 62 
54 17 17 18 0 0 0 16 36 38 0 0 52 54 0 0 0 0 0 91 94 108 108 108 108 108 108 108 108 108 108 108 108 108 239 108 108 108 61 62 
54 0 0 34 0 0 0 32 52 54 40 40 68 70 0 0 0 0 45 47 108 108 108 108 108 108 108 108 45 46 47 108 108 16 17 18 108 108 61 44 
54 0 0 34 0 0 0 32 52 54 56 56 56 73 0 0 0 0 61 44 47 108 16 18 108 108 108 45 62 44 62 47 108 32 0 34 108 45 62 62 
54 0 0 16 18 0 0 32 52 54 56 72 57 0 0 0 0 0 77 62 63 108 32 34 108 108 108 77 62 62 62 62 46 46 46 46 46 62 62 62 
54 0 0 32 16 18 0 32 52 54 56 72 73 0 0 0 0 0 123 61 63 108 32 34 108 108 108 108 77 62 62 62 44 62 62 62 62 62 62 62 
54 0 0 32 32 34 0 16 52 54 73 0 86 0 0 0 0 0 0 77 79 108 32 16 18 108 108 108 108 76 76 76 62 62 62 62 62 62 62 62 
54 0 16 18 32 34 0 32 52 54 0 16 18 0 0 0 0 0 0 123 126 108 32 32 34 108 108 108 45 62 62 62 62 62 62 62 62 62 62 62 
54 0 32 34 32 34 0 32 52 54 0 32 34 0 0 0 0 0 0 0 91 108 32 32 34 108 108 45 62 62 62 62 62 62 62 62 62 62 44 62 
54 0 32 34 32 16 17 17 52 54 0 32 34 0 0 0 0 0 91 94 108 108 32 32 16 18 108 77 44 62 62 62 62 62 62 62 62 62 62 62 
54 0 32 34 32 32 0 0 52 54 18 32 34 86 0 0 0 86 45 47 108 108 32 32 32 34 108 108 77 44 62 62 62 44 62 62 62 62 62 62 
54 17 18 34 32 32 0 0 52 54 34 32 16 18 0 0 0 45 44 79 108 108 16 18 32 34 108 108 108 76 76 76 62 62 62 62 62 62 62 62 
54 0 34 34 16 17 18 0 52 54 34 32 32 34 0 0 0 77 79 108 108 108 32 34 32 34 108 108 45 62 62 62 62 62 62 62 62 62 62 62 
54 0 34 34 32 0 34 0 52 54 34 32 32 34 0 0 91 94 108 108 108 108 32 34 32 34 108 45 62 62 62 62 62 62 62 62 62 62 62 62 
54 0 34 34 32 0 34 0 52 53 37 37 37 38 40 40 36 37 37 37 37 37 37 37 37 37 45 62 62 44 62 62 62 62 62 62 62 62 62 62 
54 0 34 34 16 18 34 0 52 53 53 53 53 54 56 56 52 53 35 53 53 53 53 53 53 53 77 78 78 78 78 78 78 78 78 78 78 78 78 78 
54 0 34 34 32 34 34 0 52 53 35 53 53 54 56 56 52 53 53 53 53 53 53 53 53 53 53 53 53 53 53 53 53 53 53 53 53 53 53 53 
54 18 34 34 32 34 34 0 52 53 53 69 69 70 73 71 68 69 53 53 53 53 53 53 53 53 35 53 53 53 53 53 53 53 53 53 53 53 53 53 
54 34 34 16 18 34 34 0 52 53 54 0 118 119 120 119 121 0 52 53 53 69 69 69 69 69 69 69 69 69 69 69 69 69 69 69 69 69 53 35 
54 34 34 32 34 34 34 16 52 53 54 133 134 135 136 135 136 138 52 53 54 0 99 100 101 0 0 0 0 0 0 99 100 101 0 0 0 0 52 53 
54 34 34 32 34 34 34 32 52 53 54 149 150 151 152 151 153 154 52 53 54 0 115 116 117 16 18 99 100 101 0 115 116 117 0 0 16 17 52 53 
54 34 34 32 16 18 34 32 52 53 54 17 18 132 132 132 132 16 52 53 54 17 18 132 0 32 34 115 116 117 16 18 132 0 0 0 32 0 52 53 
54 34 34 32 32 34 34 32 52 53 54 0 34 132 16 18 132 32 52 53 54 0 34 132 16 17 36 38 132 0 32 34 132 36 38 0 32 16 52 53 
54 17 18 32 32 34 34 32 52 53 54 0 34 36 38 34 132 32 52 53 54 0 34 132 32 0 52 54 17 17 18 34 132 52 54 0 32 32 52 53 
53 56 37 38 17 36 38 80 52 53 54 80 36 53 54 80 80 80 52 35 53 37 38 80 80 80 52 54 0 36 37 37 37 53 70 18 32 32 52 53 
53 56 53 54 40 52 54 81 68 69 70 81 52 53 54 87 81 81 52 53 53 53 54 81 81 88 52 54 0 52 53 69 69 70 0 34 32 32 52 53 
53 56 69 70 17 52 54 81 82 82 82 81 52 53 54 81 81 88 68 69 69 69 70 87 81 81 52 54 0 52 54 0 0 0 0 34 32 32 52 53 
54 56 56 56 40 52 54 81 36 37 38 81 52 35 54 81 81 81 81 81 81 81 81 81 81 81 52 54 0 68 70 17 36 38 0 16 18 32 52 53 
54 56 56 16 17 52 54 81 68 69 70 81 52 53 54 87 81 81 81 81 81 81 81 81 81 88 52 54 0 0 0 0 52 54 0 32 34 32 52 53 
54 18 56 32 0 52 54 81 82 82 82 81 52 53 54 81 81 82 82 81 81 81 82 82 81 81 52 54 80 36 37 37 53 54 0 32 34 32 52 53 
53 37 37 37 37 53 54 81 36 37 38 81 52 53 53 37 37 37 37 37 37 37 37 37 37 37 53 53 37 53 53 53 53 70 17 18 34 32 52 53 
53 53 53 53 53 53 70 81 68 69 70 81 68 53 53 53 53 53 53 69 69 69 53 35 69 69 69 69 69 69 69 69 70 57 0 34 34 32 52 53 
53 53 53 53 53 54 81 81 81 81 81 81 81 52 35 53 53 53 54 56 56 56 68 70 56 56 56 56 56 56 56 56 56 56 41 34 36 37 53 53 
53 53 53 53 53 54 81 81 81 81 81 81 81 52 53 53 53 53 54 56 56 56 56 56 56 56 56 56 56 16 17 18 56 56 56 36 53 53 53 53 
53 53 53 53 53 53 37 37 38 81 36 37 37 53 53 53 53 53 54 56 253 56 36 38 56 56 56 16 17 18 0 34 56 56 36 53 53 53 53 35 
53 53 53 53 53 53 53 53 53 37 53 53 53 53 53 35 53 53 53 37 37 37 53 53 37 37 37 37 37 37 37 37 37 37 53 53 53 53 53 53 
LAYER1
0 0 0 0 0 0 0 0 0 0 0 0 0 0 0 0 0 0 0 0 0 0 0 0 0 0 0 0 0 0 0 0 0 0 0 0 0 0 0 0 
0 0 0 0 0 0 0 0 0 0 0 0 0 0 0 0 0 0 0 0 0 0 0 0 0 0 0 0 0 0 0 0 0 0 0 0 0 0 0 0 
0 15 30 0 15 30 15 0 0 30 0 0 0 0 0 0 0 0 0 0 0 0 0 0 0 0 0 0 0 0 0 0 0 0 0 0 0 0 0 0 
0 15 0 0 15 0 30 0 0 0 0 0 0 0 0 0 0 0 0 0 0 0 0 0 0 0 0 0 0 0 0 0 0 0 0 0 0 0 0 0 
0 30 0 0 0 0 0 0 0 0 0 0 0 0 0 0 0 0 0 0 0 0 0 0 0 0 0 0 0 0 0 0 0 0 0 0 0 0 0 0 
0 0 0 0 0 0 0 0 0 0 0 0 0 0 0 0 0 0 0 0 0 0 0 0 0 0 0 0 0 0 0 0 0 0 0 0 0 0 0 0 
0 0 0 0 0 0 0 0 0 0 0 0 0 0 0 0 0 0 0 0 0 0 0 0 0 0 0 0 0 0 0 0 0 0 0 0 0 0 0 0 
0 0 0 0 0 0 0 0 0 0 0 0 0 0 0 0 0 0 0 0 0 0 0 0 0 0 0 0 0 0 0 0 0 0 0 0 0 0 0 0 
0 0 0 0 0 0 0 0 0 0 0 0 0 0 0 0 0 0 0 0 0 0 0 0 0 0 0 0 0 0 0 0 0 0 0 0 0 0 0 0 
0 0 0 0 0 0 0 0 0 0 0 0 0 0 0 0 0 0 0 0 0 0 0 0 0 0 0 0 0 62 62 62 44 0 0 0 0 0 0 0 
0 0 0 0 0 0 0 0 0 0 0 0 0 0 0 0 0 0 0 0 0 0 0 0 0 0 0 0 0 61 62 62 62 0 0 0 0 0 0 0 
0 0 0 0 0 0 0 0 0 0 0 0 0 0 0 0 0 0 0 0 0 0 0 0 0 0 0 0 0 62 62 62 62 0 0 0 0 0 0 0 
0 0 0 0 0 0 0 0 0 0 0 0 0 0 0 0 0 0 0 0 0 0 0 0 0 0 0 0 0 0 0 0 0 0 0 0 0 0 0 0 
0 0 0 0 0 0 0 0 0 0 0 0 0 0 0 0 0 0 0 0 0 0 0 0 0 0 0 0 0 0 0 0 0 0 0 0 0 0 0 0 
0 0 0 0 0 0 0 0 0 0 0 0 0 0 0 0 0 0 0 0 0 0 0 0 0 0 0 0 0 62 62 62 62 0 0 0 0 0 0 0 
0 0 0 0 0 0 0 0 0 0 0 0 0 0 0 0 0 0 0 0 0 0 0 0 0 0 0 0 0 61 62 62 62 0 0 0 0 0 0 0 
0 0 0 0 0 0 0 0 0 0 0 0 0 0 0 0 0 0 0 0 0 0 0 0 0 0 0 0 0 62 62 62 62 0 0 0 0 0 0 0 
0 0 0 0 0 0 0 0 0 0 0 0 0 0 0 0 0 0 0 0 0 0 0 0 0 0 0 0 0 0 0 0 0 0 0 0 0 0 0 0 
0 0 0 0 0 0 0 0 0 0 0 0 0 0 0 0 0 0 0 0 0 0 0 0 0 0 0 0 0 0 0 0 0 0 0 0 0 0 0 0 
0 0 0 0 0 0 0 0 0 0 0 0 0 0 0 0 0 0 0 0 0 0 0 0 0 0 0 0 0 0 0 0 0 0 0 0 0 0 0 0 
0 0 0 0 0 0 0 0 0 0 0 0 0 0 0 0 0 0 0 0 0 0 0 0 0 0 0 0 0 0 0 0 0 0 0 0 0 0 0 0 
0 0 0 0 0 0 0 0 0 0 0 0 0 0 0 0 0 0 0 0 0 0 0 0 0 0 0 0 0 0 0 0 0 0 0 0 0 0 0 0 
0 0 0 0 0 0 0 0 0 0 0 15 15 30 0 0 30 15 0 0 0 0 0 0 0 0 0 0 0 0 0 0 0 0 0 0 0 0 0 0 
0 0 0 0 0 0 0 0 0 0 0 30 15 0 0 0 0 30 0 0 0 15 15 0 0 15 30 0 0 0 15 0 0 15 15 0 15 30 0 0 
0 0 0 0 0 0 0 0 0 0 0 0 30 0 0 0 0 0 0 0 0 15 30 0 0 0 0 0 0 0 30 0 0 15 30 0 0 0 0 0 
0 0 0 0 0 0 0 0 0 0 0 0 0 0 0 0 0 0 0 0 0 0 0 0 0 0 0 0 0 0 0 0 0 30 0 0 0 0 0 0 
0 0 0 0 0 0 0 0 0 0 0 0 0 0 0 0 0 0 0 0 0 0 0 0 0 0 0 0 0 0 0 0 0 0 0 0 0 0 0 0 
0 0 0 0 0 0 0 0 0 0 0 0 0 0 0 0 0 0 0 0 0 0 0 0 0 0 0 0 0 0 0 0 0 0 0 0 0 0 0 0 
0 37 0 0 0 0 0 0 0 0 0 0 0 0 0 0 0 0 0 0 0 0 0 0 0 0 0 0 0 0 0 0 0 0 0 0 0 0 0 0 
0 35 0 0 0 0 0 0 0 0 0 0 0 0 0 0 0 0 0 0 0 0 0 0 0 0 0 0 0 0 0 0 0 0 15 0 0 0 0 0 
0 69 0 0 0 0 0 0 0 0 0 0 0 0 0 0 0 0 0 0 0 0 0 0 0 0 0 0 0 0 0 0 15 30 30 0 0 0 0 0 
0 15 30 0 0 0 0 0 0 0 0 0 0 0 0 0 0 0 0 0 0 0 0 0 0 0 0 0 0 0 0 0 0 0 0 0 0 0 0 0 
0 30 0 0 0 0 0 0 0 0 0 0 0 0 0 0 0 0 0 0 0 0 0 0 0 0 0 0 0 0 0 0 0 0 0 0 0 0 0 0 
0 0 0 0 0 0 0 0 0 0 0 0 0 0 0 0 0 0 0 0 0 0 0 0 0 0 0 0 0 0 0 0 0 0 0 0 0 0 0 0 
0 0 0 0 0 0 0 0 0 0 0 0 0 0 0 0 0 0 0 0 0 0 0 0 0 0 0 0 0 0 0 0 0 0 0 0 0 0 0 0 
0 0 0 0 0 0 0 0 0 0 0 0 0 0 0 0 0 0 0 0 0 0 0 0 0 0 0 0 0 0 0 0 0 0 0 0 0 0 0 0 
0 0 0 0 0 0 0 0 0 0 0 0 0 0 0 0 0 0 0 0 0 0 0 0 0 0 0 0 0 0 0 0 0 0 0 0 0 0 0 0 
0 0 0 0 0 0 0 0 0 0 0 0 0 0 0 0 0 0 0 0 0 0 0 0 0 0 0 0 0 0 0 0 0 0 0 0 0 0 0 0 
0 0 0 0 0 0 0 0 0 0 0 0 0 0 0 0 0 0 0 0 0 0 0 0 0 0 0 0 0 0 0 0 0 0 0 0 0 0 0 0 
0 0 0 0 0 0 0 0 0 0 0 0 0 0 0 0 0 0 0 0 0 0 0 0 0 0 0 0 0 0 0 0 0 0 0 0 0 0 0 0 
OBJECTS:
#type, x, y, dir, group
4 483 384 1 0
6 320 514 1 2
6 320 498 0 2
6 112 482 1 3
6 96 578 1 3
6 192 594 0 3
6 176 530 0 3
1 496 577 0 1
1 512 608 0 1
4 579 480 0 0
4 547 592 0 0
1 384 401 1 0
2 336 385 1 0
3 592 369 0 0
-2 499 515 0 0
5 480 160 1 0
5 480 240 1 0
-2 179 35 0 0
3 160 33 0 4
5 16 96 0 0
5 112 272 1 0
-1 146 609 0 0
1 16 529 1 0
-2 67 531 1 0
5 112 160 1 0
3 128 33 0 4
5 272 48 0 0
2 448 417 1 0
